############################
#E   #######################
#  #######                ##
##   ### # ######      ##  #
####   G##  #     ### #### #
######     ######## ######F#
############################
