###########################
##E  ######       #########
## # ###### # ### #########
## # ###### #  ##   #######
####    ### #   G##   #####
####### ### #  # ####   ###
#######     ##     ####  F#
###########################
