######################
#E      ########## ###
#### ##    ####      #
#### #####     G#### #
####   ###### ######F#
######################